{
  "layout": [
    [0,0,1,1,1,1,1,1,0,0],
    [1,1,1,1,1,1,1,1,1,1],
    [1,1,1,1,1,1,1,1,1,1],
    [1,1,1,1,1,1,1,1,1,1],
    [0,0,1,1,0,0,1,1,0,0],
    [0,0,1,1,0,0,1,1,0,0],
    [1,1,1,1,1,1,1,1,1,1],
    [1,1,1,1,1,1,1,1,1,1],
    [1,1,1,1,1,1,1,1,1,1],
    [0,0,1,1,1,1,1,1,0,0]
  ],
  "movesLeft": 15,
  "score": 0
}